NO      textures/glitter1.xpm
WE      textures/glitter2.xpm
SO      textures/glitter3.xpm
EA      textures/glitter4.xpm

F    0,0,0
C    0,0,0


111111111111
100000000001
100100000001
100000010001
100010000001
101000010001
10000S000001
100000001001
100100000001
100000010001
100000000001
111111111111


